1340 1340 1340 1340 1350 1350 1110 1110 1110 1110 0020 0020
1390 0020 1400 0020 1290 1290 0020 0020 0020 0020 0020 0020
1290 1290 1290 1290 1290 1290 1290 1290 1290 1290 0020 0020
1290 1290 1290 1290 1290 1290 1290 1290 1290 1290 0020 0020
1290 1290 1290 1290 1290 1290 1290 1290 1290 1290 0020 0020
1290 1290 1290 1290 1290 1290 1290 1290 1290 1290 0020 0020
1110 1110 1110 1110 1290 1290 1110 1110 1110 1110 0020 0020
0020 0020 0020 0020 1290 1290 0020 0020 0020 0020 0020 0020
1290 1290 1290 1290 1290 1290 1290 1290 1290 1290 0020 0020
1290 1290 1290 1290 1290 1290 1290 1290 1290 1290 0020 0020
1290 1290 1290 1290 1290 1290 1290 1290 1290 1290 0020 0020
1290 1290 1290 1290 1420 0010 1290 1290 1290 1290 0020 0020
music 02.ogg
rug 5 12 map003.map
bot 2 40 130 Zayfox: Hello, %PLAYER%!
bot 2 95 130 Scientist: Hello, %PLAYER%!
